@@@@@@@@@@@@@@@@@@@@@@@@@@@@@@@@@@@@@
@@F@@@@@@@@@@@@@@@@@@@@@@@@@@@@@@@@@@
@@     @   @   @ @     @ @       @ @@
@@@@@@ @@@ @@@ @ @@@@@ @ @@@ @ @@@ @@
@@     @   @       @         @     @@
@@@@@@ @ @@@@@@@@@ @ @@@@@@@ @@@ @@@@
@@ @   @   @ @ @ @ @ @ @ @ @   @ @ @@
@@ @@@ @ @@@ @ @ @ @ @ @ @ @ @@@ @ @@
@@ @       @   @       @   @   @   @@
@@ @ @@@ @ @@@ @ @ @ @@@ @@@@@ @@@ @@
@@ @   @ @   @   @ @   @   @ @ @ @ @@
@@ @@@@@ @@@@@@@@@ @ @@@ @@@ @ @ @@@@
@@         @     @ @     @   @ @   @@
@@ @@@@@@@ @@@ @ @ @@@@@ @ @@@@@ @@@@
@@ @ @ @ @     @   @ @ @   @   @   @@
@@@@ @ @ @@@ @@@ @ @ @ @@@@@@@ @ @ @@
@@@  @ @     @   @     @   @   @ @ @@
@@@ @@ @@@@@ @@@@@ @@@ @@@ @@@ @ @@@@
@@@ @  @   @ @ @ @   @   @ @ @     @@
@@@ @@ @ @@@@@ @ @ @@@ @@@ @ @@@ @@@@
@@@  @ @ @       @ @ @ @           @@
@@@@ @ @ @@@ @@@ @ @ @@@@@ @@@ @ @@@@
@@ @         @ @   @ @   @ @ @ @   @@
@@ @ @@@@@@@ @ @ @@@ @ @ @ @ @ @@@ @@
@@       @ @ @ @       @   @ @   @ @@
@@@@@@ @@@ @@@ @@@@@ @ @@@@@ @ @ @ @@
@@         @   @ @ @ @ @   @ @ @ @ @@
@@ @@@ @@@ @ @@@ @ @@@ @ @ @ @@@ @@@@
@@ @ @ @ @     @   @     @   @     @@
@@ @ @ @ @ @@@ @ @@@@@@@ @ @ @ @@@ @@
@@ @   @     @   @ @   @ @ @ @ @ @ @@
@@@@ @@@@@@@ @ @@@ @ @@@ @@@@@@@ @ @@
@@   @   @ @ @ @ @     @       @ @ @@
@@ @ @@@ @ @@@ @ @@@ @@@ @ @@@@@ @@@@
@@ @ @         @         @         @@
@@@@@@@@@@@@@@@@@@@@@@@@@@@@@@@@@@P@@
@@@@@@@@@@@@@@@@@@@@@@@@@@@@@@@@@@@@@
