@@@@@@@@@@@@@@@@@@@@@@@@@@@@@@@@@@@@@@@@@@@@@@@@@@@@@
@@@@F@@@@@@@@@@@@@@@@@@@@@@@@@@@@@@@@@@@@@@@@@@@@@@@@
@@ @   @         @   @     @ @       @   @ @       @@
@@ @ @ @ @ @@@ @@@ @ @ @ @ @ @@@ @@@ @ @ @ @ @@@@@@@@
@@   @ @ @   @ @   @ @ @ @   @   @ @   @   @ @     @@
@@ @@@ @@@@@ @ @ @@@ @ @ @@@ @ @@@ @ @@@@@ @ @ @ @ @@
@@ @   @   @ @ @ @ @   @   @ @   @ @ @   @ @ @ @ @ @@
@@ @ @@@@@ @ @ @ @ @@@@@@@ @@@@@ @ @ @ @ @@@ @ @ @ @@
@@ @       @ @ @       @ @   @   @ @   @     @ @ @ @@
@@ @@@@@ @@@ @ @@@@@@@ @ @@@ @ @@@ @@@@@@@@@@@ @@@ @@
@@ @       @ @   @   @ @   @ @       @ @ @ @     @ @@
@@ @ @ @@@@@ @ @@@ @@@ @ @ @ @@@@@ @@@ @ @ @@@@@ @ @@
@@ @ @     @ @       @   @ @ @ @ @       @       @ @@
@@ @@@@@@@@@ @@@@@@@ @@@ @@@ @ @ @@@@@@@ @@@@@ @@@ @@
@@ @   @     @   @ @   @ @   @       @ @   @   @ @ @@
@@ @ @ @ @@@@@ @ @ @ @@@ @ @ @@@ @@@ @ @@@ @ @@@ @ @@
@@ @ @   @     @   @ @   @ @     @ @ @   @   @   @ @@
@@ @ @@@@@@@ @ @@@ @ @ @@@ @@@@@ @ @ @ @@@@@@@ @ @ @@
@@ @     @   @ @   @     @     @ @       @     @ @ @@
@@ @@@@@ @ @@@ @@@@@@@@@ @@@@@ @@@ @@@@@@@@@ @@@ @ @@
@@     @   @   @       @     @ @   @         @ @ @ @@
@@ @@@ @@@@@ @ @ @@@@@ @@@ @ @ @@@ @ @@@@@ @@@ @ @ @@
@@   @   @   @ @ @ @   @   @ @   @ @     @ @   @ @ @@
@@ @@@ @ @ @@@@@ @ @ @@@@@@@@@@@ @@@@@ @ @ @ @ @ @ @@
@@ @   @ @   @   @   @ @     @   @     @ @ @ @ @ @ @@
@@@@ @@@@@@@ @ @@@@@ @ @ @@@ @@@ @ @ @@@ @ @ @ @ @ @@
@@ @   @     @ @   @     @ @   @   @   @ @ @ @ @ @ @@
@@ @ @ @ @@@@@ @ @ @@@@@@@ @@@ @@@@@@@ @@@ @ @ @ @ @@
@@   @ @   @   @ @ @     @         @   @   @ @   @ @@
@@ @@@ @ @@@ @@@ @ @ @@@ @@@ @@@@@ @ @@@ @@@ @@@@@ @@
@@ @   @   @ @   @ @ @ @   @ @     @ @   @ @ @ @ @ @@
@@ @ @@@@@ @ @ @@@ @ @ @@@ @@@@@ @ @@@ @@@ @ @ @ @ @@
@@ @       @   @ @ @     @     @ @ @   @     @   @ @@
@@ @@@ @@@@@@@@@ @ @@@@@ @@@@@ @@@ @ @@@ @@@@@ @ @ @@
@@ @ @ @     @   @ @ @ @ @     @     @   @     @ @ @@
@@ @ @ @@@ @ @@@ @ @ @ @ @ @@@@@@@@@@@ @@@ @@@@@ @ @@
@@   @     @     @ @   @ @         @   @   @   @ @ @@
@@ @@@@@@@@@@@ @@@ @ @ @ @@@@@@@@@ @ @@@@@ @ @ @ @ @@
@@ @   @   @   @   @ @ @ @ @     @ @     @ @ @ @ @ @@
@@ @ @ @ @ @ @@@ @@@ @ @ @ @ @@@ @ @@@@@ @ @ @ @ @ @@
@@ @ @ @ @   @   @ @ @ @ @   @   @   @   @ @ @   @ @@
@@ @ @ @@@ @@@ @ @ @ @ @ @ @@@ @ @@@ @@@ @ @@@ @@@ @@
@@ @ @   @ @   @   @ @   @   @ @ @ @   @ @   @   @ @@
@@ @ @@@ @@@ @@@ @@@ @@@@@@@ @ @@@ @@@ @ @@@ @ @@@ @@
@@ @   @   @ @     @     @   @   @   @ @     @   @ @@
@@@@@@ @@@ @ @ @@@@@@@@@ @@@@@ @ @ @@@ @@@@@@@ @@@ @@
@@     @     @ @     @   @   @ @   @   @       @   @@
@@ @@@ @ @@@@@ @ @ @@@ @@@ @ @@@@@ @ @@@@@ @ @@@ @@@@
@@ @   @   @   @ @     @   @     @ @ @   @ @   @ @ @@
@@ @@@@@@@@@@@@@ @@@@@@@ @ @ @@@ @ @ @ @ @@@@@@@ @ @@
@@                       @ @ @     @   @           @@
@@P@@@@@@@@@@@@@@@@@@@@@@@@@@@@@@@@@@@@@@@@@@@@@@@@@@
@@@@@@@@@@@@@@@@@@@@@@@@@@@@@@@@@@@@@@@@@@@@@@@@@@@@@
