@@@@@@@@@@@@@@@@@@@@@@@
@@@@@@@@@@@F@@@@@@@@@@@
@@     @@ @  @   @   @@
@@ @@@ @@ @@ @@@ @ @ @@
@@ @    @  @     @ @ @@
@@ @@@@@@@ @@@@@ @@@ @@
@@         @     @   @@
@@@@ @@@ @ @ @@@@@ @@@@
@@ @   @ @ @       @ @@
@@ @ @@@ @@@@@@@@@ @ @@
@@   @     @     @   @@
@@@@@@ @@@ @@@@@ @@@ @@
@@   @   @   @   @ @ @@
@@ @ @@@ @@@ @ @@@ @ @@
@@ @     @ @   @     @@
@@ @@@@@@@ @@@@@ @@@@@@
@@   @     @   @     @@
@@@@ @ @@@@@@@ @@@@@ @@
@@   @   @   @     @ @@
@@ @@@ @@@ @ @ @ @@@ @@
@@         @   @     @@
@@@@@@@@@@@@P@@@@@@@@@@
@@@@@@@@@@@@@@@@@@@@@@@